198,151,173,152,173,32,173,151,175,174,175,197,32,175,197,196,196,151,196,55,150,198,198,174,198,150,32,173,197,173,152,196
173,174,151,196,150,32,175,198,198,151,152,198,32,152,198,150,173,152,173,9,151,174,175,175,150,173,55,196,174,150,198,175
196,198,150,174,198,55,151,151,197,198,151,151,55,175,173,152,173,150,151,9,150,152,150,198,174,152,9,173,197,151,151,175
198,150,152,196,152,9,175,151,197,196,152,196,32,174,151,174,196,197,152,55,150,152,197,173,175,151,55,198,196,150,152,150
150,174,197,175,150,9,173,196,151,198,150,197,9,150,152,150,198,150,196,55,173,152,174,174,174,174,9,152,174,197,175,152
174,175,173,173,173,9,173,174,175,173,197,198,9,196,221,139,140,219,198,55,150,173,150,197,196,151,9,196,197,151,196,152
175,175,175,173,173,55,173,174,175,173,197,198,55,176,161,162,163,164,172,9,150,173,150,197,196,151,9,196,197,151,196,152
150,150,174,198,175,9,176,196,150,152,152,197,55,176,184,185,186,187,172,9,196,198,150,175,196,151,9,151,175,151,197,197
174,175,175,198,196,55,198,175,175,198,150,175,55,176,207,208,209,210,172,32,176,152,175,151,150,198,55,174,174,196,173,197
198,152,174,175,175,32,150,152,173,151,197,198,9,176,230,231,232,233,172,55,176,175,173,196,151,197,32,151,174,173,151,175
175,174,197,174,152,32,175,198,197,173,175,175,32,176,253,254,255,256,172,9,151,175,196,150,175,173,55,196,152,152,196,198
175,152,196,151,174,55,197,174,174,197,198,197,9,176,276,277,278,279,172,55,173,173,151,196,151,197,9,175,152,198,151,198
197,198,196,173,173,9,175,175,175,196,152,197,55,198,129,161,161,127,151,32,175,197,196,151,151,151,32,150,175,150,174,196
175,150,197,197,197,32,176,173,151,174,196,151,55,173,196,49,49,49,173,32,174,174,173,151,151,198,32,151,173,151,152,196
198,151,198,152,173,32,173,175,150,175,175,197,55,175,198,196,196,151,196,9,150,198,198,174,198,150,55,173,197,173,152,196
197,196,197,174,150,32,175,173,173,150,152,198,9,152,173,150,173,152,173,32,151,152,175,151,150,173,32,196,175,150,198,175
152,174,175,197,198,32,151,198,197,150,196,151,32,175,175,152,173,150,151,55,150,174,150,175,174,152,32,173,151,197,175,175
150,150,198,175,152,55,152,173,196,198,151,196,32,174,150,174,196,197,152,55,150,151,197,173,175,151,9,198,196,197,198,174
197,152,196,150,150,32,150,150,197,197,152,197,9,150,152,150,174,150,196,32,173,152,174,174,174,174,9,152,174,197,175,152
174,151,175,173,173,32,173,198,151,198,152,198,55,175,174,175,173,197,174,32,150,173,150,197,196,151,55,196,197,151,196,152
150,151,174,198,175,9,176,196,151,173,151,197,55,150,197,175,197,198,151,32,196,198,150,175,196,151,9,151,175,151,197,197
174,198,175,198,196,9,198,175,152,174,150,175,32,175,173,152,197,150,175,55,176,152,175,151,150,198,9,174,174,196,173,197
198,152,174,175,175,9,150,152,173,175,197,198,55,175,150,173,198,151,173,9,176,175,173,196,151,197,32,151,174,173,151,175
175,174,197,174,152,55,175,198,197,151,175,175,55,175,151,197,151,175,174,55,151,175,196,150,175,173,9,196,152,152,196,198
175,197,175,151,174,32,197,174,174,173,198,197,55,198,150,175,198,174,174,9,173,173,151,196,151,197,55,175,152,198,151,198
197,198,173,173,173,9,175,175,175,151,152,197,32,198,152,152,196,196,151,9,175,197,196,151,151,151,9,150,175,150,174,196
175,150,173,197,197,9,176,173,151,150,196,151,9,173,196,174,151,151,173,32,174,174,173,151,151,198,55,151,173,151,152,196
198,151,173,152,173,9,173,151,175,150,175,197,9,175,198,196,174,150,196,9,150,198,198,174,198,150,55,173,197,173,152,196
197,173,150,174,150,55,175,198,198,150,152,198,9,152,151,150,151,152,173,32,151,152,175,151,150,173,32,196,175,150,198,175
152,198,198,197,198,55,151,151,197,198,151,151,32,175,174,152,196,150,151,32,150,174,150,175,174,152,55,173,151,197,175,175
150,150,198,175,152,9,175,151,197,196,152,196,9,174,198,196,196,197,152,9,150,151,197,173,175,151,9,198,196,197,198,174
197,152,196,150,150,9,173,196,151,198,150,197,32,150,173,150,174,150,196,55,173,152,174,174,174,174,55,152,174,197,175,152
